6000000000000000000000000000000000000006
6000000000000000000000000000000000000006
6000000000000000000000000000000000000006
6000000000000000000000000000000000000006
6000000000000000000000000000000000000006
6000000000000000000000000000000000000006
6000000000000000000000000000000000000006
6122222222222222222222222222222222222236
6666666666666666666666666666666666666666
6666666666666666666666666666666666666666
6666666666666666666666666666666666666666
