0000000d00000000000000000
0000000000000000000000000
0000000000000000000000000
0000000000000000000000000
0000000000000000000000000
00000gggggg00000000000000
0000012222300000000000000
0000046666500000000000000
0000046666500000000000000
0000046666500000000000000
0000000000000000000000000
00000000000000sss00000000
