0000000000000d00000000000d0000000000000000000000000000
00000000d00000000d000000000000000000000000000000000000
000000000000000000000000000000000000000000000000000000
000000000000000000000000000p00000000000000000000000000
000000000000000000000tgggggg00000000000000000000000000
000000000000000000000122222300000000p0g000000000000000
00000ggggg000000000000666660000000tggg1000000000000000
00000122230000000sss000066600sss0012222000000000000000
0000046665000000p0000000000000000046665000000000000000
0000000000000gggg0000000000000000000000000000000000000
000000000000012230000000000000000000000000000000000000
000000000000046650000000000000000000000000ss0000000000
sss000000000000000000000000000000000000000000000000000
