0000000000000d00000000000000d0000000000000000000000000
00000000d00000000d000000000000000000000000000000000000
000000000000000000000000000000000000000000000000000000
000000000000000000000000000000000000000000000000000000
0000000000000000000000000gggg0000000000000000000000000
0000000p000000000p000000122300000000000000000000000000
00000gggtgggggggggtg0000466500000000000000000000000000
000001222222222222220000000000000000000000000000000000
00000466666666666665000000000000ss00000000000000000000
000000000000000000000000000000000000000000000000000000
000000000000000000000000000000000000000000000000000000
0000000000000000000000sss00000000000000000000000000000
000000000000000000000000000000000000000000000000000000
