000000d0000000000000000000000000000000
0000000000000000000d000000000000000000
00000000000000000000000000d00000000000
00000000000000000000000000000000000000
00000000000000000000000000000000000000
000000000000000000p0000000000000000000
00000ggg0000000gggg0000000000000000000
0000012200000012223000000p000000000000
00000465000000466650000tggg00000000000
00000666000000666600000122300000000000
00000660ss0000000000000066600000000000
00000000000000000000000006600000000000
sssss000000000000000sss00000000sss0000
