000000000000d0000000000000000000000000
0000000000000000000d0000000p0000000000
000000000000000000000000tggggg00000000
00000000000000000000000012222300000000
00000000000000000000000066600000000000
0000000000000000000p000066000000000000
00000ggggg000000ggggg00000000000000000
0000012223000000122230ss00000000000000
00000466650000004666500000000000000000
00000066660000006666000000000000000000
0000000066ssssss6600000000000000000000
00000000000000000000000000000000000000
sss000000000000000000000000000sss00000
