0000000d00000000000000000000000000
00000000000000000d0000000000000000
0000000000000000000000000000000000
000000000000000000000000000p000000
0000000000000000000000000gggg00000
0000000000000000000000000122300000
00000tgggggggggggggg00000466500000
0000012222222222222300000000000000
0000046666666666666500000000000000
0000046666666666666500000000000000
0000046666666666666500000000000000
0000000000000000000000000000000000
00000000000000sss00000000000000000
