0000000d00000000000000000
0000000000000000000000000
0000000000000000000000000
0000000000000000000000000
0000000000p00000000000000
00a00gggggg00000000000000
00a0012222300000000000000
0000046666500000000000000
0000046666500000000000000
0000046666500000000000000
0000000000000000000000000
00000000000000sss00000000
