0000000000000000000000000000000000000000000000000000000000000000000000
0000000000000000000000000000000000000000000000000000000000000000000000
0000000000000000000000000000000000000000000000000000000000000000000000
0000000000000000000000000000000000000000000000000000000000000000000000
0000000000000000000000000000000000000000000000000000000000000000000000
0000000000000000000000000000000000000000000000000000000000000000000000
0000000000000000000000000000000000000000000000000000000000000000000000
0000000000000000000000000000000000000000000000000000000000000000000000
gggggggg00000ggggg0000000000000000000000000000000000000000000000000000
1222222300000122230000000000000000000000000000000000000000000000000000
4666666500000466650000000000000000000000000000000000000000000000000000
4666666500000466650000000000t00000000000000t000000000000000000000t0000
4666666500000466662222222222222222222222222222222222230000000012222223
4666666500000466666666666666666666666666666666666666650000000046666666
4666666500000466666666666666666666666666666666666666650000000046666666
4666666500000000000000000000000000000000000000000000000000000000000000
46666665gggggggggggggggggggggggggggggggggggggggggggggggggggggggggggggg
4666666512222222222222222222222222222222222222222222222222222222222223
4666666666666666666666666666666666666666666666666666666666666666666665
4666666666666666666666666666666666666666666666666666666666666666666665