0000000000000000000000000000000000000000000000000000000000000000000000
00000000000000000000000000000000000t000ggg0000000000000000000000000000
0000000000000000000000000000000000012222230000000000000000000000000000
0000000000000000000000000000000000046666650000000000000000000000000000
0000000000000000000000000000000000000666000000000000000000000000000000
gggggggg00000ggggg0000000000000000000066000000000000000000000000000000
1222222300000122230000000000000000000000000000000000000000000000000000
4666666500000466650000000000000000000000000000000000000000000000000000
4666666500000466650000000000t00000000000000t000000000001222300000t0000
4666666500000466662222222222222222222222222222222222230466650012222223
4666666500000466666666666666666666666666666666666666650006650046666666
4666666500000466666666666666666666666666666666666666650006650046666666
4666666500000000000000000000000000000000000000000000000006650000000000
46666665ggggggggggggggggggggggggggggggggggggggggggggggggg665gggggggggg
4666666512222222222222222222222222222222222222222222222222222222222223
4666666666666666666666666666666666666666666666666666666666666666666665
4666666666666666666666666666666666666666666666666666666666666666666665