00000000000000000000000000
00000000000000000000000000
00000000000000000000000000
tgggggggggg000000000000000
12222222223000000000000000
46666666665000000000000000
46666666665000000000000000
46666666665000000000000000
